xxxxxxxxxxxx
x   xk  x  x
xs  xx  x  x
xxx  x  x  x
xi   x     x
xxxx    xxxx
x   cxx   hj
xax        x
xxxxxxxxxxxx
